o---------------
----oo.---------
---oooooo-------
---ooooooooo----
----ooSoooooo---
---------ooToo--
---------ooo----
----------------
